Name	Role	Company	Attended
Aadil Shadman Malik	Chief Content Officer	ProPakistani	2 MWCs
Aamir Ibrahim	CEO Jazz	JazzWorld	2 MWCs & 1 M360
Aamir Ahsan Khan	President & CEO	Ericsson Pakistan	2 MWCs
Aaron Lopez Perez	CEO	Amplify Software SL	MWC26 Barcelona
Aaron Simpson	Founder CEO	Kindred	MWC26 Barcelona
Aaron Watson	CFO	iQmetrix	MWC26 Barcelona
Aarti Prabhu	Product Marketer	VVDN Technologies	MWC26 Barcelona
Abbey Alidoosti	CEO	AWTG Ltd	MWC26 Barcelona
Abbi Pilapitiya	Director/CEO	Sierra	MWC26 Barcelona
Abbo Bello	Director	Cameroon Telecommunications	MWC26 Barcelona
Abdallah Abzakh	Managing Director	DOTCONVERTECS	2 MWCs
Abdallah Touhami	Managing Director	Accenture	MWC26 Barcelona
Abdelmonem Mohamed Ahmed Khawaga	CEO	UNI group	MWC26 Barcelona
Abdelrahman Mohamed Fady Moh Aboelella	CTO	Digis Squared	MWC26 Barcelona
Abdujabor Kayumov	CEO Telecommunication Services	Beeline Kazakhstan (Kar-Tel LLP)	MWC26 Barcelona
Abdul Usmani	Chief Product Officer	PMCL - Jazz	MWC26 Barcelona
Abdul Wahab	Chief Delivery Officer	Truminds Software Systems	MWC26 Barcelona
Abdul Basit Alvi	VP of Product	ng-voice	MWC26 Barcelona
Abdulla Ebrahim Al Ahmed	CGVO	e&	MWC26 Barcelona
Abdullah Albusairi	COO/CPO	USim	2 MWCs
Abdullah Yildirim	Ceo	Globalfocus	MWC26 Barcelona
Abdun Naser Khan	Secretary	Posts and Telecommunications Division	MWC26 Barcelona
Abdun Naser Khan	Secretary	Posts and Telecommunications Division	MWC26 Barcelona
Abed Alzain	CTO	SellEnvo	MWC26 Barcelona
Abel Avellan	CEO	AST SpaceMobile	MWC26 Barcelona
Abhijit Kishore	Chief Executive Officer	Vodafone Idea Limited	MWC26 Barcelona
Abhinav Saxena	CTO	TAISYS Technologies Co., Ltd.	MWC26 Barcelona
Abhishek Malhotra	SVP& Business Head - Network Services	Tech Mahindra	MWC26 Barcelona
Abhishek Saxena	Managing Director	TAISYS Technologies Co., Ltd.	MWC26 Barcelona
Abhishek Srivastava	Vice President	Deutsche Telekom Digital Labs	MWC26 Barcelona
Abhrajit Ray	PARTNER	Deloitte Touche Tohmatsu India LLP	MWC26 Barcelona
Abolaji Idowu	CFO	9Mobile	MWC26 Barcelona
Achraf Ammour	Deputy General Director in charge of Morocco	DIGITAL VIRGO	MWC26 Barcelona
Ada Cervera	UX Researcher	Payment Innovation Hub	MWC26 Barcelona
Adam Anbari	GM	Azurreo	MWC26 Barcelona
Adam Andersson	VP of Sales & Business Development	BEAMMWAVE AB (@4YFN )	MWC26 Barcelona
Adam Butler	Director	Signal Solutions Limited	MWC26 Barcelona
Adam Emrich	Vice President, Solutions and Sales	Southern Linc	MWC26 Barcelona
Adam Epstein	Co-CEO and President	adMarketplace	MWC26 Barcelona
Adam Gontarz	Head of Digitalization, Innovation and Technology	Swissmem	MWC26 Barcelona
Adam Grill	CEO and Industry Analyst	Odyssey Group	MWC26 Barcelona
Adam Hayes	Chief Operating Officer (COO)	Eseye Ltd	MWC26 Barcelona
Adam Kirwan	Operations	Jet Network Solutions	MWC26 Barcelona
Adam Weinberg	Founder & CTO	FirstPoint Mobile Guard	MWC26 Barcelona
Adan Salcedo Ferrandez	Business Development Director	Mycelium Networks	MWC26 Barcelona
Adebayo Ojo	Head Internal Control	ProvidusBank	MWC26 Barcelona
Adel Joudallah	CEO	Radix Technologies	MWC26 Barcelona
Adel Louis	vice President	Mada	MWC26 Barcelona
Adel Tamano	Chief Commercial Officer	DITO TELECOMMUNITY CORPORATION	2 MWCs
Adela Caushi	CIO	Orange Slovakia	MWC26 Barcelona
Adelyn Ong	Managing Director	China Mobile International (Singapore)	MWC26 Barcelona
Adem Öcal	Chairman of the Board	NETGSM COMMUNİCATİON AND INFORMATION TECHNOLOGIES INC	MWC26 Barcelona
Adeola Mogaji	CEO	OPTICS AND WIRELESS LIMITED	2 MWCs
Adham Mehdawi	CTO	Top Mena Talents	2 MWCs
Adil Belihomji	CTO	OXIO	MWC26 Barcelona
Adil El Youssefi	Global Head of Colocation	Cassava Technologies	MWC26 Barcelona
Aditi Khinvasara	Co-Founder	The Ravit Show	MWC26 Barcelona
Aditya Malhotra	Founder & CEO	Skor	MWC26 Barcelona
Aditya Raj Khosla	CEO	Taylormade Technologies Limited	MWC26 Barcelona
Adnan Aftab	CEO	Air Link Communication Limited	MWC26 Barcelona
Adnan Hayat Zaidi	Chief Executive Officer	Multinet Pakistan Private Limited	MWC26 Barcelona
Adnan Siddique	Chief Executive Officer	SCTechnologies Global	MWC26 Barcelona
Adolfo Borrero Villalón	CEO	Aalto Consultores SL	MWC26 Barcelona
Adolfo Gastalver Rubio	CEO	PLOID AI BIOTECH, S.L.	MWC26 Barcelona
Adolfo Herrera Juarez	CEO	Sistemas Ibertronica SL	MWC26 Barcelona
Adrian Carrasco	CRO	miUrba	MWC26 Barcelona
Adrian Croitor	Managing Director	Just Plus	MWC26 Barcelona
Adrian Di Pietrantonio	EVP Global Strategy & Growth	Dubber	MWC26 Barcelona
Adrian Dick	Chief Transformation Officer	2degrees New Zealand	MWC26 Barcelona
Adrian Edmunds	CEO	OnXR	MWC26 Barcelona
Adrian Gallardo	Director de Operaciones y Programas	AticcoLab	MWC26 Barcelona
Adrian Gomez	Country Manager	Randstad Digital	MWC26 Barcelona
Adrian Janon	CEO	nGulam	1 MWC & 2 M360s
Adrian Ježina	CEO	Telemach Croatia	MWC26 Barcelona
Adrian Johnston	Innovation Commissioner	Innovation City Belfast	MWC26 Barcelona
Adrian Li Mow Ching	CEO	Clicks	MWC26 Barcelona
Adrian McDonald	President EMEA	Dell Technologies	MWC26 Barcelona
Adrian O'Connor	CEO	Benetel	2 MWCs
Adrian Skardhamar	Director of Product and Technology	Slice Mobile	MWC26 Barcelona
Adrian Valdeolmillos	Chief Growth Officer	URAPHEX	MWC26 Barcelona
Adriana Freitas	Partner	Muster Ventures	MWC26 Barcelona
Adriana Galarza Ramirez	CPO	Bankuish Inc	MWC26 Barcelona
Adriano Galano	Sales Specialist HPC & AI	Hewlett Packard Enterprise	MWC26 Barcelona
Adriano Schneider	Head of Global Operations	bycoders_	MWC26 Barcelona
Adriano Marcelo Pires	CEO	Maminfo Soluções	MWC26 Barcelona
Adrien Tay	CTO, Smart Transportation	Huawei	MWC26 Barcelona
Adrián Crovetto	FOUNDER & CEO	SEGURNUBE ZERO RISK CORREDURIA DE SEGUROS, SOCIEDAD LIMITADA	MWC26 Barcelona
Adrián Domínguez	Producer	TBS (Telefónica Broadcast Services)	MWC26 Barcelona
Adrián Dorado	Chief Innovation Officer	Qualud	MWC26 Barcelona
Adrián Fernández Platero	COO	Glue Digital	MWC26 Barcelona
Adrián Gorricho	Strategy and new business	Kunsen	MWC26 Barcelona
Adrián Inchausti Ibáñez	Chief of audiovisual distribution	AJR Vision	MWC26 Barcelona
Adrián Palancar	CEO	INCENTALIA	MWC26 Barcelona
Adrián Picazo García	Account Manager Sector Público	Fujitsu	MWC26 Barcelona
Adrián Ruiz Del Cerro Freixanet	COFOUNDER & CREATIVE DIRECTOR	FUTURA SPACE	MWC26 Barcelona
Afke Schaart	SVP Global Affairs	Eutelsat Group	MWC26 Barcelona
Afolabi Oladunjoye	Chief Operating Officer	Ntel	MWC26 Barcelona
Afonso Oliveira Barros	CEO	MAC GROUP STANDS SL	MWC26 Barcelona
Agabek Bozorboev	CTO	"Green White Solutions" LLC	MWC26 Barcelona
Agnes Zinn	CEO	Wall Universe GmbH	MWC26 Barcelona
Agung Bowo Laksono	CEO	PT Asia Quattro Net (AQN)	MWC26 Barcelona
Agustin Bignu	Cofounder	GEO Metrics	MWC26 Barcelona
Agustín Bertamoni	CEO & Co-Founder	STECHS	MWC26 Barcelona
Ahmad Al Neama Abdulaziz	Group Regional CEO North Africa & Asia	Ooredoo Group	2 MWCs
Ahmad Ali	Director of Operations	Saudi Net Link	MWC26 Barcelona
Ahmad Bassam	Head of Communications	MENA TECH	2 MWCs
Ahmad Husseini	Chief Technology Officer	Ericsson	MWC26 Barcelona
Ahmad Malkawi	CEO	Global Telecom	2 MWCs
Ahmad Shukair	Chief Technical Officer - Middle East & Africa	Mavenir	2 MWCs
Ahmad Vakili	Chief R&D Officer	Summit Tech	MWC26 Barcelona
Ahmed Mohamed	CEO of Fintech & Digital Lifestyle	e& Egypt	MWC26 Barcelona
Ahmed Abd Oun	Wholesale Manager	JiBAL	MWC26 Barcelona
Ahmed Abdelaal	CEO	Najd Telecom Company	MWC26 Barcelona
Ahmed Abdelrazzaq	General Manager	VTEL Jordan	MWC26 Barcelona
Ahmed Abdelshafy	KAM Etisalat UAE	Ericsson	MWC26 Barcelona
Ahmed Al Shuaili	CFO	Vodafone Oman	MWC26 Barcelona
Ahmed Almehyas Al-Ali Mohamed Abdulla	Chairman	Viahub Communications Corporation	MWC26 Barcelona
Ahmed Alsaidi	CEO	Sellenvo, Inc.	MWC26 Barcelona
Ahmed Asif	Head of Stakeholder Relations	Grameenphone Ltd.	MWC26 Barcelona
Ahmed El Beheiry	Group COO and Group Chief Technology & AI Officer	Cassava Technologies	MWC26 Barcelona
Ahmed Mokhtar	CEO	GreySkies Inc.	MWC26 Barcelona
Ahmed Rakwi	CEO	Taurus Arm	MWC26 Barcelona
Ahmed Abdulsalam Abood Albayatti	CTO	Zain Iraq	MWC26 Barcelona
Ahmed Ahmed Ahmed Abououf	General Manager	Etisal Trading	MWC26 Barcelona
Ahmed Armaan Siddiqui	CEO	Grameen HealthTech Ltd	MWC26 Barcelona
Ahmed Bilal Masud	CEO AI & Cloud Business	Huawei Technologies Co Ltd	MWC26 Barcelona
Ahmed Faisal Abbas Ahmed	CTO	Sudatel Telecom Group	MWC26 Barcelona
Ahmed Suleiman Kh Eshakruni	Engineer	Libya Telecom and Technology	MWC26 Barcelona
Ahmet Kaya	Sales Director, Government & Public Sector	Odine	MWC26 Barcelona
Ahmet Burak Gocmen	CTO	LOGO YAZILIM SANAYİ VE TİCARET ANONİM ŞİRKETİ	MWC26 Barcelona
Ahmet Gokhan Ay	Chief Consumer Officer	e&	MWC26 Barcelona
Aidan Nutley	VP Sales	Zinkworks	MWC26 Barcelona
Aiguo Long	Project Executive	Beijing SYMA Exhibition Engineering Co.,Ltd.	MWC26 Barcelona
Aik Hong Ang	CEO	IP-Tribe Pte Ltd	2 MWCs
Ailan Khertek	CPO	Stape	MWC26 Barcelona
Aimen Said Ammar Sabkha	Giga for Telecommunication and Technology Limited	Giga for Telecommunication and Technology Limited	2 MWCs & 1 M360
Aina Bellver Sanchis	CSO & co-founder	Flavii Therapeutics S.L.	MWC26 Barcelona
Aina Rodriguez	CEO	Intermèdia Comunicació	MWC26 Barcelona
Ainoa Irurre Perez	Europe Talent Acquisition & Mobility Vice President	Schneider Electric	MWC26 Barcelona
Aiping Li	COMMERCIAL DIRECTOR	Huawei Technologies Co., Ltd.	MWC26 Barcelona
Aitor Moll Sarasola	Conseller Delegat	Prensa Ibérica	MWC26 Barcelona
Aiwu Peng	VP	Shenzhen huazhen information technology Co.,Ltd	MWC26 Barcelona
Aja Martinez	CPO	Boundless Devices	MWC26 Barcelona
Ajay Joseph	Chief Technology Officer (CTO)	iBasis, Inc	MWC26 Barcelona
Ajay Shekhar Sharma	Chief Business Officer	Paytm	MWC26 Barcelona
Ajay Veer Yadav	Senior Vice President	Flipkart	MWC26 Barcelona
Ajey Anand	CEO	Norigin Media	MWC26 Barcelona
Aji Ed	VP, Head of AI-RAN, Cloud RAN and SMO	Nokia	MWC26 Barcelona
Akadiat Paterne	General Manager	Fonds de Développement du Service Universel	MWC26 Barcelona
Akash Bhatia	Managing Director and Senior Partner	Boston Consulting Group	MWC26 Barcelona
Akash Raj Komarlu	CTO & Co-founder	Whispp	MWC26 Barcelona
Akbar Ghahri	CEO	Samantel MVNO	MWC26 Barcelona
Akib Sayyed	Founder	Matrix Shell Technologies Pvt Ltd	MWC26 Barcelona
Akihiro Kumagai	Executive Officer	SORAJIMA	MWC26 Barcelona
Akinwale Goodluck	DEPUTY CEO	AFRICANENDA FOUNDATION	2 MWCs
Akunna Ibe	Communications Specialist	UNICEF Giga	MWC26 Barcelona
Alain Sanchez	EMEA CISO	Fortinet	MWC26 Barcelona
Alan Howarth	Chairman	Cerillion	MWC26 Barcelona
Alan Murphy	CTO	VOX Solutions	MWC26 Barcelona
Alba Forns	Co-Founder & COO	Climatize Earth	MWC26 Barcelona
Alba Guzmán	coCEO	ROSAPARKS	MWC26 Barcelona
Albany Cordova	Senior Sales Manager	Informa	MWC26 Barcelona
Albert Serra	Director of Innovation	Gremi d'Hotels de Barcelona	MWC26 Barcelona
Albert Almajano	CIO Iberia	BBraun	MWC26 Barcelona
Albert Anglarill	Director Territorial y de Proyectos Cataluña	AMETIC	MWC26 Barcelona
Albert Barbera	Scientific Director	Fundació Docencia i Recerca Mutua Terrassa	MWC26 Barcelona
Albert Calvo	Researcher	i2CAT	MWC26 Barcelona
Albert Castro	CEO	MERIDIANA	MWC26 Barcelona
Albert Chamorro	CEO	V2 Group	MWC26 Barcelona
Albert Colomer Espinet	President	Autoocupació	MWC26 Barcelona
Albert Cot Sanz	Managing Partner	Inveniam	MWC26 Barcelona
Albert Domingo Melgosa	CEO	NexTReT	MWC26 Barcelona
Albert Duaigües Manuel	CEO	RawData	MWC26 Barcelona
Albert Ferre	CEO	GLTH / Global Legaltech Hub	MWC26 Barcelona
Albert Isern	Founder & CEO	ATENEA Artificial Intelligence	MWC26 Barcelona
Albert Luengo	Customer Product Mgr.	G+D	MWC26 Barcelona
Albert Mascarell	CHIEF OF TECH TRANSFER	MOBILE WORLD CAPITAL BARCELONA	2 MWCs
Albert Matas-Claramunt	Director of IT	Forvis Mazars in Spain	MWC26 Barcelona
Albert Mundet	General Manager	Barça Innovation Hub	2 MWCs
Albert Perez Vila	CFO	CCEP	MWC26 Barcelona
Albert Perez Vila	CFO	CCEP	MWC26 Barcelona
Albert Prats Vidal	CISO	Port de Barcelona	MWC26 Barcelona
Albert Riba Barea	PARTNER	DELOITTE	MWC26 Barcelona
Albert Rivero	Partner	WORSLEY CONSULTING SL	MWC26 Barcelona
Albert Schönhöfer	CEO	eScribAI	MWC26 Barcelona
Albert Solana	CTO	MINDSIGHT VENTURES	MWC26 Barcelona
Albert Villa-Real	President and CEO	PLDT Global	MWC26 Barcelona
Alberto Antiza	Co-founder	Shush Digital	MWC26 Barcelona
Alberto Bengue	President of Port of Luanda	Port of Luanda	MWC26 Barcelona
Alberto Blázquez	Tech partner	Golden Gamers Go	MWC26 Barcelona
Alberto Cubero	Country Manager	Limak	MWC26 Barcelona
Alberto Gonzalez	GLOBAL CORPORATE SOLUTIONS DIRECTOR	TELEFONICA GLOBAL SOLUTIONS	MWC26 Barcelona
Alberto Hospital	CEO	Premoney	MWC26 Barcelona
Alberto Manganaro	Deputy CEO - France	Huawei Technologies Co Ltd	2 MWCs
Alberto Marin Vidal	CEO	CompanyGame	MWC26 Barcelona
Alberto Martín Fernández	COO	ROAMS	MWC26 Barcelona
Alberto Miralles	CEO	Drelife	MWC26 Barcelona
Alberto Montenegro	CEO and Founder	SpeakersPro	MWC26 Barcelona
Alberto Patron	Chief Executive Officer (CEO)	Condor Technologies	MWC26 Barcelona
Alberto Ripepi	Group Chief Network Officer	Vodafone Group Services Limited	MWC26 Barcelona
Alberto Romero	Chief Product Officer	Flimin	MWC26 Barcelona
Alberto Rosas	CEO	Didit	MWC26 Barcelona
Alberto Sierra	Co-founder	KRONIS	MWC26 Barcelona
Alberto Valero Santiago	Head of Large Enterprise & Public market in Spain	Seidor	MWC26 Barcelona
Albrecht Von Der Recke	CEO fonYou EMEA	fonYou Technologies	MWC26 Barcelona
Aldebarán Bermell-Scorcia Armendáriz	Founder	EMENDU	MWC26 Barcelona
Ale Parise	CEO	Robots For Humanity	MWC26 Barcelona
Alec Barton	Founder & CEO	Developing Telecoms Ltd.	MWC26 Barcelona
Aleix Serrahima	CCO & Co-Founder	Made of Genes	MWC26 Barcelona
Aleix Valls Tomas	CEO	We Artificial	MWC26 Barcelona
Alejandra Fernández Cobo	CEO	Fenia Advise	MWC26 Barcelona
Alejandra Prieto	Head of Innovation	CultTech Association	MWC26 Barcelona
Alejandro Castro Valdés	Director de Producto	PROACTIVANET	MWC26 Barcelona
Alejandro Fuster	CTO	SpainDC	MWC26 Barcelona
Alejandro Peverengo	Chief Innovation & Security Officer	COELSA	MWC26 Barcelona
Alejandro Adamowicz	Strategic Engagement and Technology Regional Director	GSMA Latin America	2 MWCs & 1 M360
Alejandro Albuerne	CPO	Resizes	MWC26 Barcelona
Alejandro Arranz Stancel	Open innovation and New Technologies Director	Mahou San Miguel	MWC26 Barcelona
Alejandro Benítez	Socio Fundador	CONNECTIA 2B	MWC26 Barcelona
Alejandro Campos	CEO	Imprex Europe S.L.	MWC26 Barcelona
Alejandro Campos	CEO	Imprex Europe S.L.	MWC26 Barcelona
Alejandro Casanova García	CTO	Datadope	MWC26 Barcelona
Alejandro Garbiras	Atrato Media, S.L.	ATRATO MEDIA	MWC26 Barcelona
Alejandro González Gallardo	Founder & CEO	Crata AI	MWC26 Barcelona
Alejandro Mañez	CEO & Founder	Digital Robots	MWC26 Barcelona
Alejandro Medina Giron	CTO	Future Connections	MWC26 Barcelona
Alejandro Muñoz Reyes	CEO	doppio mobile	1 MWC & 1 M360
Alejandro Ortiz Monedero	COO	Moabits	MWC26 Barcelona
Alejandro Pereira Zambrano	Fundador y CEO	Mentelem - Mental health at work	MWC26 Barcelona
Alejandro Pinzon	CEO	DRUO	MWC26 Barcelona
Alejandro Ponce Yuste	Cofounder & CRO	Bold Factory	MWC26 Barcelona
Alejandro Sospedra Roca	CTO	HeyThalia	MWC26 Barcelona
Alejandro Torres	Regional Director	Norigin Media	MWC26 Barcelona
Alejo Costa Ribalta	General Partner at CRB Health Tech SGEIC	CRB Health Tech SGEIC	MWC26 Barcelona
Alejo Daudí	Director	Anobi Group (Redos Robotics)	MWC26 Barcelona
Aleksandar Belanović	COO	Orion Telekom	MWC26 Barcelona
Aleksandar Brankovic	CTO	IPification	MWC26 Barcelona
Aleksandar Lekic	Founder & CEO	Auralis Talent Xplore	MWC26 Barcelona
Aleksandr Abalakin	CMO / CCO	DefendSphere	MWC26 Barcelona
Aleksandr Babichev	CEO	Mobile Telecom-Service Limited Liability Partnership	1 MWC & 1 M360
Aleksandr Konovalov	CoFounder & CTO	Wordzzz	MWC26 Barcelona
Aleksandrs Korolkovs	CTO	CSC TELECOM SIA	MWC26 Barcelona
Aleksei Chistiakov	Co-founder	Stape	MWC26 Barcelona
Alem Hailemariam Yirgaw	Deputy Network Infrastructure Chief Officer	Ethio telecom	MWC26 Barcelona
Alena Fedotova	Executive Vice-President Sales	Eurasiana IT Solutions LLC	MWC26 Barcelona
Alessandra Pennuto	COO	smartFAB	MWC26 Barcelona
Alessandra Speranza	CEO / creative director	CLHUB.ART	MWC26 Barcelona
Alessandro Bovone	CTO	JT Group	MWC26 Barcelona
Alessandro De Losa	CEO	Babylon Cloud SPA	MWC26 Barcelona
Alessandro Gropelli	Director General	Connect Europe	MWC26 Barcelona
Alessandro Liani	CEO	Video Systems Srl	MWC26 Barcelona
Alessandro Aimar	CTO	Synthara AG	MWC26 Barcelona
Alessandro Cammarano	CTO	Osmium	MWC26 Barcelona
Alessandro Caranci	CCO	Satport	MWC26 Barcelona
Alessandro De Sario	CEO and Co-founder	Therapyside	MWC26 Barcelona
Alessandro Di Salvo	Country Manager	Italtel Spain	MWC26 Barcelona
Alessandro Palmisano	CEO & co founder	TrenDevice	MWC26 Barcelona
Alessandro Pignati	AI Security Researcher	NeuralTrust	MWC26 Barcelona
Alessandro Puglia	Vice President | Head of Telco Media and High Tech Italy	Capgemini Invent	MWC26 Barcelona
Alessandro Rivello	Chief Information Officer	Grandi Stazioni Retail	MWC26 Barcelona
Alessandro Schintu	Director of Sales	Huawei Technologies Italia S.r.l. (“Huawei”)	MWC26 Barcelona
Alessio Calenda	COO	Mettis AI	MWC26 Barcelona
Alessio Grumiro	CTO	Kalibios AG	MWC26 Barcelona
Alex Algard	Founder & CEO	Hiya	MWC26 Barcelona
Alex Balderstone	Co-Founder	Kaiku	MWC26 Barcelona
Alex Bisbe	CEO	VOICEB.ai	MWC26 Barcelona
Alex Blay	Head of Strategic Partnerships	Mifundo	MWC26 Barcelona
Alex Cabaneros	COO	Biel Glasses	MWC26 Barcelona
Alex Caudet	CSO & Managing Director	Dost	MWC26 Barcelona
Alex Colcher	Senior Vice President LAD strategic Accounts	Oracle	MWC26 Barcelona
Alex Dahlke	Managing Director	Accenture GmbH	MWC26 Barcelona
Alex Jauregui	Country Manager Spain	MAXCOM S.A.	MWC26 Barcelona
Alex Katouzian	Group GM - Mobile, Compute, XR & Wearables	Qualcomm Technologies	MWC26 Barcelona
Alex Liu	SVP, Product & Business	FuriosaAI	MWC26 Barcelona
Alex Llagostera	Head of M&A	Call2World	MWC26 Barcelona
Alex Mauri Ruiz	Business Controller Manager	Sysmex	MWC26 Barcelona
Alex Peleg	Co-Founder and Director	Cilynx	MWC26 Barcelona
Alex Pereira	CEO & Co-founder	AIRLINGO LABS S.L.	MWC26 Barcelona
Alex Petre	Regional Sales Director	Evam	MWC26 Barcelona
Alex Santos	General Partner	Chamaeleon	MWC26 Barcelona
Alex Siboe	CIO	stanbic	MWC26 Barcelona
Alex Tan	Chief Sales Officer	U Mobile	2 MWCs
Alex Jonathan Kung	Founder	Alex Jonathan Kung	MWC26 Barcelona
Alex Santos Fernandez Gensana	Account Manager	FORTINET	MWC26 Barcelona
Alexander Arun	CEO	Engagenest Technologies	MWC26 Barcelona
Alexander Belugin	Chief Product Officer	XPANCEO	MWC26 Barcelona
Alexander Cheskis	Co-Founder and CEO	Larch Networks	MWC26 Barcelona
Alexander Gizis	CEO	Connectify	MWC26 Barcelona
Alexander Havang	Chief Technical Officer	AppLogic Networks	MWC26 Barcelona
Alexander Hess	Country Manager Germany	Assurant	MWC26 Barcelona
Alexander Hofmann	Chief Business Development Manager	Fraunhofer IIS	MWC26 Barcelona
Alexander Jenbar	CTO	Telekom Deutschland GmbH	MWC26 Barcelona
Alexander Kübler	CEO & Co-Founder	roboa AG	MWC26 Barcelona
Alexander Rahe	CEO, Co-Founder	NidoSync	MWC26 Barcelona
Alexander Renz	Co-Founder and CSO	CASTANET	MWC26 Barcelona
Alexander Shulman	CTO	Tototheo Global	MWC26 Barcelona
Alexander Sum	Sr. VP Sales Marketing	GCT Semiconductor	2 MWCs
Alexander Westlund	CEO	Lynes Technologies	MWC26 Barcelona
Alexander Woellwarth	Chief AI Officer	Rhapsody Media Group	MWC26 Barcelona
Alexander Wood	CEO | CCO & Founder	Lexicon Lore Experiential Agency	MWC26 Barcelona
Alexander Martin Dethof	CTO	AVEQ GmbH	MWC26 Barcelona
Alexandr Zorin	Staff	Alpha Crew	MWC26 Barcelona
Alexandra Jorissen	EMEA Business Development	IdentifAI	MWC26 Barcelona
Alexandra Lluro	Promoter	Faireurope	MWC26 Barcelona
Alexandra Rasch	Founder & CEO	Caban Energy	MWC26 Barcelona
Alexandra Santos	COO	Impulse4Women	MWC26 Barcelona
Alexandre Pebereau	Chairman & Founder	Tofane Digital	MWC26 Barcelona
Alexandre Audoin	Head of Industries & Practices	Capgemini Engineering	MWC26 Barcelona
Alexandre Benoin	International Marketing & Sales Executive	sanofi	MWC26 Barcelona
Alexandre Demain	CEO & Co-Founder	Chift	MWC26 Barcelona
Alexandre Goixart	Operations Manager	Starshot Software	MWC26 Barcelona
Alexandre Paoleschi	CEO	Fenix DFA	MWC26 Barcelona
Alexandre Rocha	CTO/CEO	AAR Telecom	MWC26 Barcelona
Alexandros Giouzenis	CTO	Navarino	MWC26 Barcelona
Alexandros Bregiannis	CEO	NOVAICT	MWC26 Barcelona
Alexey Yanson	Managing Director	LANCK Telecom	2 MWCs
Alexey Kosachev	Director	Conundrum Industrial	MWC26 Barcelona
Alexey Rychko	Head of DPI	7Generation	1 MWC & 1 M360
Alexi Kirilenko	Director	3i	MWC26 Barcelona
Alexis Bartelds	CEO	Sam Media BV	MWC26 Barcelona
Alexis Slepoy	Gerente	Cámara Argentina de Cooperativas de Telecomunicaciones- CATEL	MWC26 Barcelona
Alfio Di Mauro	CEO	Mosaic SoC Ltd	MWC26 Barcelona
Alfons Eric Bosch Sansa	Chief Marketing Officer	XLSMART	MWC26 Barcelona
Alfonso Aguiriano De Rojas	CEO	ESB SISTEMAS ESPAÑA	MWC26 Barcelona
Alfonso Ayuso	CEO	Minos Global	MWC26 Barcelona
Alfonso De Castaneda Calvo	Director	Zonamovilidad.es	MWC26 Barcelona
Alfonso Fontalba	Co Founder	LITEN LEMON MARKETING, S.L.	MWC26 Barcelona
Alfonso Juan Alvarez Villamarin	CEO	Cellnex Spain	MWC26 Barcelona
Alfred Hannig	Chief Executive Officer	Alliance for Financial Inclusion	MWC26 Barcelona
Alfred Ortiz	Chief Operating Officer	CSD CYBER	MWC26 Barcelona
Alfred Luis Villa Real	President and CEO	Communigate Technologies Inc.	MWC26 Barcelona
Alfredo Avila Sanchez	Iberia Sales Director II Head of FSI Global	VASS	MWC26 Barcelona
Alfredo Gonzalez Herrero	Partner	Case Management Consultants	MWC26 Barcelona
Alfredo Parreño	CTO	Importaciones CarHub S.L	MWC26 Barcelona
Alfredo Saenger	Founder	Electrogenos	MWC26 Barcelona
Ali Kuralkan	CEO	TEKNOSER	MWC26 Barcelona
Ali Asgharzadeh	Chief Strategy Officer	MLOS LTD	2 MWCs
Ali Durmus	CTO	ETIYA	MWC26 Barcelona
Ali Gazioglu	Co-Founder	Roamless	MWC26 Barcelona
Ali Ocal	Chief Operating Officer (COO)	NETGSM	MWC26 Barcelona
Ali Parsa	CEO and Founder	Quadrivia	MWC26 Barcelona
Ali Shah	CTO	Evamp & Saanga	2 MWCs
Ali Yassin	Chief Operations Officer	Touch	MWC26 Barcelona
Ali Emre Erisen	CEO - Co Founder	EDIS Disaster and Earthquake Systems	MWC26 Barcelona
Ali Çağatay Kuru	Product Management Executive	Nish Business Solutions	MWC26 Barcelona
Aliaksandr Blinkou	CTO	Aloteq	MWC26 Barcelona
Alicia M Iglesias	CEO	Lewis & Carroll	MWC26 Barcelona
Alin Valentin Gherman	CHIEF EXECUTIVE OFFICER	NOBEL LTD	MWC26 Barcelona
Alina Potapenko	Operations manager	VIAJEGROUP	MWC26 Barcelona
Aline Loiseau	Co-founder & Chief Commercial & Operations Officer	Apeiroon	MWC26 Barcelona
Alisa Dzic	Head of SMS Department	VX Telecom Group	MWC26 Barcelona
Alisdair Gunn	Director	Glasgow City Innovation District	MWC26 Barcelona
Alison Young	CEO	Kansys	MWC26 Barcelona
Alistair Castillo	CTO IOT BUSINESS	MELITA LIMITED	MWC26 Barcelona
Alla Oparienko	COO	Limited Liability Company “NUR Telecom”	MWC26 Barcelona
Allan Davidson	Founder and Host	SoundBtyes / CBS News	MWC26 Barcelona
Allan Fairbairn	Chief Technology and Digital Officer	Helios Towers	MWC26 Barcelona
Allan Kelman Ajuz	CEO	TELECALL	2 MWCs
Allan Pires	Board Member	CapiAnalytics	MWC26 Barcelona
Allen Lin	Vice President	Zyxel Communications	MWC26 Barcelona
Allen Proithis	CEO	Capstone Partners	MWC26 Barcelona
Allen C. Bayard	CEO	ACCESS HAITI S.A.	MWC26 Barcelona
Allwyn Kent	Co-Founder	Vonnue	MWC26 Barcelona
Almando Cox	CEO	ResolveIT Limited	MWC26 Barcelona
Alonso Fernandez	Globa Head of Products	NTT Data Inc	MWC26 Barcelona
Alper Terlemez	GM	Smartmic	MWC26 Barcelona
Alper Yegin	CEO	LoRa Alliance	MWC26 Barcelona
Alper Tunga Sagu Burak	CEO	Odine	MWC26 Barcelona
Alpha Camara	CHIEF FINANCIAL OFFICER	Webbfontaine Guinea	MWC26 Barcelona
Alpheus Mangale	Group Chief Executive Officer	Seacom	MWC26 Barcelona
Alvaro Eguinoa	Managing Director	SAFETWICE	MWC26 Barcelona
Alvaro Fernandez De Araoz	CEO	Correcta Digital	MWC26 Barcelona
Alvaro L. Revuelta	Founder	Bilinear Labs	MWC26 Barcelona
Alvaro León Camacho	partner	EY	MWC26 Barcelona
Alvaro Loeschbor	ceo	esolutions	MWC26 Barcelona
Alvaro Rocha	SVP CALA	WESCO ANIXTER	MWC26 Barcelona
Alvaro Rojas	CO-CEO	DISTESA	MWC26 Barcelona
Alvaro Vigil Rodriguez	Sales Director EMEA	MedUX	MWC26 Barcelona
Alvis Huang	Founder & CEO	EMTAR Technologies Inc	MWC26 Barcelona
Aly Govani	CEO	Airfind	MWC26 Barcelona
Alysson Gabriel Rosa	COO	KDM INTERNET TELECOMUNICAÇÕES LTDA	MWC26 Barcelona
Ama Adorkor Edjah	Chief Finance Officer	PPL Net Ghana Ltd	MWC26 Barcelona
Amadou Niang	Key Account Manager Angola	Ericsson	MWC26 Barcelona
Amaka Ezike	CFO	FBIS Technologies LTD	MWC26 Barcelona
Amalia Capilla	CEO	Miramoon Pharma	MWC26 Barcelona
Amanda Brock	CEO	OPEN UK	MWC26 Barcelona
Amanda Wei	CMO Europe	oppo	MWC26 Barcelona
Amane Dannouni	Managing Director and Partner	Boston Consulting Group (BCG)	MWC26 Barcelona
Amane Oshima	President & CEO	Japan ICT Fund	MWC26 Barcelona
Amare Tadesse	Sales Director	Huawei Technologies Co., Ltd	3 MWCs
Amaury Touzelet	Head of Sales Europe	Lillybelle	MWC26 Barcelona
Ambar Amleh	Managing Partner	Ibtikar Fund	MWC26 Barcelona
Amelia Liu	COO&Co-founder	StarWin	MWC26 Barcelona
Amer Abubaker	CSO	MOSECO	MWC26 Barcelona
Amer Atallah	CSO UAE office	ZTE Corporation	MWC26 Barcelona
Amer Gilani	Head of Business Development	Smart Forum	MWC26 Barcelona
Amer Gilani	VP Commercial	Evamp & Saanga	MWC26 Barcelona
Americo Lenza	Business Development	Trackimo	MWC26 Barcelona
Amir Barnea	VP Sales	Hybrid Access	MWC26 Barcelona
Amir Ghaly	CEO	Synteligo	MWC26 Barcelona
Amir Kandel	Sales Director	HEQA Security	MWC26 Barcelona
Amir Lugasi	CSO	Flycomm	MWC26 Barcelona
Amir Meir	CTO	Ubiqam	MWC26 Barcelona
Amir Yafe	SVP, Sales & Business Development	Gilat Satellite Networks	MWC26 Barcelona
Amirata Gharehgazlou	VP Operations	Data Access Solutions Inc	MWC26 Barcelona
Amit Arora	CEO	SARVASYA PTE LIMITED	MWC26 Barcelona
Amit Gupta	Chief Business Officer	Amantya Technologies Private Limited	MWC26 Barcelona
Amit Gupta	Chief Sales Officer	Gunship Technologies	MWC26 Barcelona
Amit Jain	SVP / GM In-Building Networks	Airspan Networks	MWC26 Barcelona
Amit Jaju	Senior Managing Director	Ankura Consulting	MWC26 Barcelona
Amit Kalley	CEO	Infosys Equinox	MWC26 Barcelona
Amit Pasari	CEO	XS INFOSOL PRIVATE LIMITED	MWC26 Barcelona
Amit Relan	CEO & Co-Founder	mFilterIt	MWC26 Barcelona
Amit Segev	CTO & Co Founder	Avon AI	MWC26 Barcelona
Amitabh Mathur	Co-founder & Chief Operating Officer	Truminds Software Systems	2 MWCs
Amitabh Pandey	Managing Director & President - Ericsson Sri Lanka & Maldives	Ericsson	MWC26 Barcelona
Ammar Osman	VP & CTO	Grand Block Technologies LLC.	2 MWCs
Amr Mohamed	Founder & CEO	Neumetria	MWC26 Barcelona
Amrish Goyal	President	LifeStation	MWC26 Barcelona
Amrit Ashish Rai	senior director	GigHub Systems INC	MWC26 Barcelona